AAAU - Goldman Sachs Physical Gold ETF Shares
AACBR - Artius II Acquisition Inc. - Rights
AACG - ATA Creativity Global - American Depositary Shares, each representing two common shares
AAON - AAON, Inc. - Common Stock
AAPG - Ascentage Pharma Group International - American Depository Shares
AARD - Aardvark Therapeutics, Inc. - Common Stock
ABCL - AbCellera Biologics Inc. - Common Shares
ABFL - Abacus FCF Leaders ETF
ACAD - ACADIA Pharmaceuticals Inc. - Common Stock
ACCO - Acco Brands Corporation Common Stock
ACHR - Archer Aviation Inc. Class A Common Stock
ACRS - Aclaris Therapeutics, Inc. - Common Stock
ACXP - Acurx Pharmaceuticals, Inc. - Common Stock
ADAG - Adagene Inc. - ADS, each representing 1.25 ordinary shares
ADBE - Adobe Inc. - Common Stock
ADFI - Anfield Dynamic Fixed Income ETF
ADSEW - ADS-TEC ENERGY PLC - Warrant
AEMD - Aethlon Medical, Inc. - Common Stock
AEVA - Aeva Technologies, Inc. - Common Stock
AFG - American Financial Group, Inc. Common Stock
AFGC - American Financial Group, Inc. 5.125% Subordinated Debentures due 2059
AFYA - Afya Limited - Class A Common Shares
AGFY - Agrify Corporation - Common Stock
AGGA - Astoria Dynamic Core US Fixed Income ETF
AGGY - WisdomTree Yield Enhanced U.S. Aggregate Bond Fund
AGL - agilon health, inc. Common Stock
AGRW - Allspring Exchange-Traded Funds Trust Allspring LT Large Growth ETF
AHLT - American Beacon Select Funds American Beacon AHL Trend ETF
AIEQ - Amplify ETF Trust Amplify AI Powered Equity ETF
AIMD - Ainos, Inc. - Common Stock
AIMDW - Ainos, Inc. - warrants
AIRJW - AirJoule Technologies Corporation - Warrant
AIYY - Tidal Trust II YieldMax AI Option Income Strategy ETF
AKAM - Akamai Technologies, Inc. - Common Stock
ALC - Alcon Inc. Ordinary Shares
ALDFU - Aldel Financial II Inc. - Units
ALEX - Alexander & Baldwin, Inc. Common Stock REIT Holding Company
ALGN - Align Technology, Inc. - Common Stock
ALL - Allstate Corporation (The) Common Stock
ALLE - Allegion plc Ordinary Shares
ALLO - Allogene Therapeutics, Inc. - Common Stock
ALMS - Alumis Inc. - Common Stock
ALRS - Alerus Financial Corporation - Common Stock
ALTO - Alto Ingredients, Inc. - Common Stock
AMCX - AMC Networks Inc. - Class A Common Stock
AMDG - Leverage Shares 2X Long AMD Daily ETF
AMED - Amedisys Inc - Common Stock
AMKR - Amkor Technology, Inc. - Common Stock
AMOM - QRAFT AI-Enhanced U.S. Large Cap Momentum ETF
AMTM - Amentum Holdings, Inc. Common Stock
AMZN - Amazon.com, Inc. - Common Stock
ANRO - Alto Neuroscience, Inc. Common Stock
AOD - abrdn Total Dynamic Dividend Fund Common Shares of Beneficial Interest
AORT - Artivion, Inc. Common Stock
AOS - A.O. Smith Corporation Common Stock
AOUT - American Outdoor Brands, Inc. - Common Stock
APDN - Applied DNA Sciences, Inc. - Common Stock
APG - APi Group Corporation Common Stock
APLU - Allspring Exchange-Traded Funds Trust Allspring Core Plus ETF
APPN - Appian Corporation - Class A Common Stock
AQMS - Aqua Metals, Inc. - Common Stock
AQNB - Algonquin Power & Utilities Corp. 6.20% Fixed-to-Floating Subordinated Notes Series 2019-A due July 1, 2079
ARDT - Ardent Health, Inc. Common Stock
ARDX - Ardelyx, Inc. - Common Stock
AREA - Harbor ETF Trust Harbor AlphaEdge Next Generation REITs ETF
AREBW - American Rebel Holdings, Inc. - warrants
ARES - Ares Management Corporation Class A Common Stock
ARKA - EA Series Trust ARK 21Shares Active Bitcoin Futures Strategy ETF
ARKB - ARK 21Shares Bitcoin ETF Common Shares of Beneficial Interests
ARKG - ARK Genomic Revolution ETF
ARKO - ARKO Corp. - Common Stock
ARKZ - EA Series Trust ARK 21Shares Active Ethereum Futures Strategy ETF
ARR - ARMOUR Residential REIT, Inc.
ARVN - Arvinas, Inc. - Common Stock
AS - Amer Sports, Inc. Ordinary Shares
ASIA - Matthews International Funds Matthews Pacific Tiger Active ETF
ASM - Avino Silver & Gold Mines Ltd. Common Shares (Canada)
ASR - Grupo Aeroportuario del Sureste, S.A. de C.V. Common Stock
ASYS - Amtech Systems, Inc. - Common Stock
ATCOL - Atlas Corp. - 7.125% Notes due 2027
ATIIU - Archimedes Tech SPAC Partners II Co. - Unit
ATKR - Atkore Inc. Common Stock
ATLCL - Atlanticus Holdings Corporation - 6.125% Senior Notes due 2026
ATMV - AlphaVest Acquisition Corp - Ordinary Shares
ATNM - Actinium Pharmaceuticals, Inc. (Delaware) Common Stock
ATO - Atmos Energy Corporation Common Stock
ATXS - Astria Therapeutics, Inc. - Common Stock
AUGP - PGIM S&P 500 Buffer 12 ETF - August
AUMI - Themes Gold Miners ETF
AUTL - Autolus Therapeutics plc - American Depositary Shares
AVAL - Grupo Aval Acciones y Valores S.A. ADR (Each representing 20 preferred shares)
AVDS - American Century ETF Trust Avantis International Small Cap Equity ETF
AVGE - American Century ETF Trust Avantis All Equity Markets ETF
AVGV - American Century ETF Trust Avantis All Equity Markets Value ETF
AVIG - Avantis Core Fixed Income ETF
AVIV - Avantis International Large Cap Value ETF
AVLV - Avantis U.S. Large Cap Value ETF
AVMU - Avantis Core Municipal Fixed Income ETF
AVNS - Avanos Medical, Inc. Common Stock
AVO - Mission Produce, Inc. - Common Stock
AVUQ - Avantis U.S. Quality ETF
AWF - Alliancebernstein Global High Income Fund
BAERW - Bridger Aerospace Group Holdings, Inc. - Warrant
BAH - Booz Allen Hamilton Holding Corporation Common Stock
BAK - Braskem SA ADR
BALT - Innovator Defined Wealth Shield ETF
BAMO - Brookstone Opportunities ETF
BAMV - Brookstone Value Stock ETF
BANX - ArrowMark Financial Corp. - Closed End Fund
BBCA - JPMorgan BetaBuilders Canada ETF 
BBN - BlackRock Taxable Municipal Bond Trust Common Shares of Beneficial Interest
BCDA - BioCardia, Inc. - Common Stock
BCE - BCE, Inc. Common Stock
BCGWW - Binah Capital Group, Inc. - Warrants
BCHI - The 2023 ETF Series Trust II GMO Beyond China ETF
BCLI - Brainstorm Cell Therapeutics Inc. - Common Stock
BCS - Barclays PLC Common Stock
BCUS - Exchange Listed Funds Trust Bancreek U.S. Large Cap ETF
BEAGU - Bold Eagle Acquisition Corp. - Units
BEGS - Collaborative Investment Series Trust Rareview 2x Bull Cryptocurrency & Precious Metals ETF
BEKE - KE Holdings Inc American Depositary Shares (each representing three Class A Ordinary Shares)
BEN - Franklin Resources, Inc. Common Stock
BEPC - Brookfield Renewable Corporation Brookfield Renewable Corporation Class A Subordinate Voting Shares
BFAP - First Trust Exchange-Traded Fund FT Vest Bitcoin Strategy Floor15 ETF   April
BFJL - First Trust Exchange-Traded Fund FT Vest Bitcoin Strategy Floor15 ETF   July
BFRZ - Innovator ETFs Trust Innovator Equity Managed 100 Buffer ETF
BFZ - BlackRock California Municipal Income Trust
BGSF - BGSF, Inc. Common Stock
BGT - BlackRock Floating Rate Income Trust
BHFAO - Brighthouse Financial, Inc. - Depositary Shares, each representing a 1/1,000th interest in a share of 6.750% Non-Cumulative Preferred Stock, Series B
BHR - Braemar Hotels & Resorts Inc. Common Stock
BHST - BioHarvest Sciences Inc. - Common Stock
BIDU - Baidu, Inc. - American Depositary Shares, each representing 8 ordinary share
BIL - SPDR Bloomberg 1-3 Month T-Bill ETF
BINC - iShares Flexible Income Active ETF
BIRD - Allbirds, Inc. - Class A Common Stock
BITC - Bitwise Trendwise Bitcoin and Treasuries Rotation Strategy ETF
BITF - Bitfarms Ltd. - Common Stock
BITQ - Bitwise Crypto Industry Innovators ETF
BITU - ProShares Trust ProShares Ultra Bitcoin ETF
BJAN - Innovator U.S. Equity Buffer ETF - January
BK - The Bank of New York Mellon Corporation Common Stock
BKCI - BNY Mellon ETF Trust BNY Mellon Concentrated International ETF
BKHA - Black Hawk Acquisition Corporation - Class A Ordinary Shares
BKIE - BNY Mellon International Equity ETF
BKMC - BNY Mellon US Mid Cap Core Equity ETF
BKNG - Booking Holdings Inc. - Common Stock
BKUI - BNY Mellon Ultra Short Income ETF
BL - BlackLine, Inc. - Common Stock
BLRX - BioLineRx Ltd. - American Depositary Shares
BLUX - Exchange Traded Concepts Trust Bluemonte Dynamic Total Market ETF
BLZE - Backblaze, Inc. - Class A Common Stock
BMY - Bristol-Myers Squibb Company Common Stock
BNED - Barnes & Noble Education, Inc Common Stock
BNJ - Brookfield Finance Inc. 4.50% Perpetual Subordinated Notes
BNKU - Bank Of Montreal MicroSectors  U.S. Big Banks 3  Leveraged ETNs due February 17, 2045
BNRG - Brenmiller Energy Ltd - Ordinary Shares
BNZIW - Banzai International, Inc. - Warrant
BOC - Boston Omaha Corporation Class A Common Stock
BOCT - Innovator U.S. Equity Buffer ETF - October
BOEG - Leverage Shares 2X Long BA Daily ETF
BOEU - Direxion Daily BA Bull 2X Shares
BOF - BranchOut Food Inc. - Common Stock
BOLT - Bolt Biotherapeutics, Inc. - Common Stock
BOSC - B.O.S. Better Online Solutions - Ordinary Shares
BOTT - Themes Robotics & Automation ETF
BOX - Box, Inc. Class A Common Stock
BOXX - EA Series Trust Alpha Architect 1-3 Month Box ETF
BPAY - iShares FinTech Active ETF
BPOP - Popular, Inc. - Common Stock
BPYPP - Brookfield Property Partners L.P. - 6.50% Class A Cumulative Redeemable Perpetual Preferred Units
BRAG - Bragg Gaming Group Inc. - Common Shares
BRAZ - Global X Funds Global X Brazil Active ETF
BRC - Brady Corporation Common Stock
BRIA - BrilliA Inc Class A Ordinary Shares
BRKR - Bruker Corporation - Common Stock
BRLSW - Borealis Foods Inc. - Warrant
BRNY - Burney U.S. Factor Rotation ETF
BSCP - Invesco BulletShares 2025 Corporate Bond ETF
BSCZ - Invesco BulletShares 2035 Corporate Bond ETF
BSJS - Invesco BulletShares 2028 High Yield Corporate Bond ETF
BSJX - Invesco BulletShares 2033 High Yield Corporate Bond ETF
BSMP - Invesco BulletShares 2025 Municipal Bond ETF
BSR - Northern Lights Fund Trust II Beacon Selective Risk ETF
BSRR - Sierra Bancorp - Common Stock
BSSX - Invesco BulletShares 2033 Municipal Bond ETF
BSVN - Bank7 Corp. - Common stock
BSVO - EA Bridgeway Omni Small-Cap Value ETF
BTCZ - T-Rex 2X Long Bitcoin Daily Target ETF
BTF - CoinShares Valkyrie Bitcoin and Ether Strategy ETF
BTMWW - Bitcoin Depot Inc. - Warrant
BTSG - BrightSpring Health Services, Inc. - Common Stock
BUFG - FT Vest Buffered Allocation Growth ETF
BUFM - AB Moderate Buffer ETF
BUL - Pacer US Cash Cows Growth ETF
BUSEP - First Busey Corporation - Depositary Shares, Each Representing a 1/40th Interest in a Share of 8.25% Fixed-Rate Series B Non-Cumulative Perpetual Preferred Stock, $0.001 par value
BVS - Bioventus Inc. - Class A Common Stock
BWBBP - Bridgewater Bancshares, Inc. - Depositary Shares, Each Representing a 1/100th Interest in a Share of 5.875% Non-Cumulative Perpetual Preferred Stock, Series A
BWEB - Bitwise Funds Trust Bitwise Web3 ETF
BYD - Boyd Gaming Corporation Common Stock
BYRE - Principal Exchange-Traded Funds Principal Real Estate Active Opportunities ETF
CAI - Caris Life Sciences, Inc. - Common Stock
CAN - Canaan Inc. - American Depositary Shares
CANC - Tema Oncology ETF
CAR - Avis Budget Group, Inc. - Common Stock
CARZ - First Trust S-Network Electric & Future Vehicle Ecosystem ETF
CASH - Pathward Financial, Inc. - Common Stock
CASY - Caseys General Stores, Inc. - Common Stock
CATX - Perspective Therapeutics, Inc. Common Stock
CBNA - Chain Bridge Bancorp, Inc. Class A Common Stock
CBOE - Cboe Global Markets, Inc. Common Stock
CBTA - Calamos ETF Trust Calamos Bitcoin 80 Series Structured Alt Protection ETF - April
CBXA - Calamos ETF Trust Calamos Bitcoin 90 Series Structured Alt Protection ETF - April
CBZ - CBIZ, Inc. Common Stock
CCBG - Capital City Bank Group - Common Stock
CCCXU - Churchill Capital Corp X - Unit
CCIRU - Cohen Circle Acquisition Corp. I - Unit
CCK - Crown Holdings, Inc.
CCL - Carnival Corporation Common Stock
CDIOW - Cardio Diagnostics Holdings Inc. - Warrant
CDLR - Cadeler A/S American Depositary Share (each representing four (4) Ordinary Shares)
CDNA - CareDx, Inc. - Common Stock
CDROW - Codere Online Luxembourg, S.A. - Warrants
CDTTW - Conduit Pharmaceuticals Inc.  - Warrant
CECO - CECO Environmental Corp. - Common Stock
CEE - The Central and Eastern Europe Fund, Inc. (The) Common Stock
CELH - Celsius Holdings, Inc. - Common Stock
CEPO - Cantor Equity Partners I, Inc. - Class A Ordinary Shares
CET - Central Securities Corporation Common Stock
CETH - 21Shares Core Ethereum ETF
CFFI - C&F Financial Corporation - Common Stock
CFIT - Cambria ETF Trust Cambria Fixed Income Trend ETF
CGBDL - Carlyle Secured Lending, Inc. - 8.20% Notes due 2028
CGHY - Capital Group Fixed Income ETF Trust Capital Group High Yield Bond ETF
CGMS - Capital Group U.S. Multi-Sector Income ETF
CHAU - Direxion Daily CSI 300 China A Share Bull 2X Shares
CHCI - Comstock Holding Companies, Inc. - Class A Common Stock
CHD - Church & Dwight Company, Inc. Common Stock
CHMG - Chemung Financial Corp  - Common Stock
CHR - Cheer Holding, Inc.  - Class A Ordinary Share
CHSN - Chanson International Holding - Class A Ordinary Shares
CHTR - Charter Communications, Inc. - Class A Common Stock
CI - The Cigna Group Common Stock
CIBR - First Trust NASDAQ Cybersecurity ETF
CII - BlackRock Enhanced Large Cap Core Fund, Inc. Common Stock
CIIT - Tianci International, Inc. - Common Stock
CINT - CI&T Inc Class A Common Shares
CION - CION Investment Corporation Common Stock
CJMB - Callan JMB Inc. - Common Stock
CLFD - Clearfield, Inc. - Common Stock
CLOD - Themes Cloud Computing ETF
CLOI - VanEck ETF Trust VanEck CLO ETF
CLYM - Climb Bio, Inc. - Common Stock
CMBS - iShares CMBS Bond ETF
CMPOW - CompoSecure, Inc.  - Warrant
CMRE - Costamare Inc. Common Stock $0.0001 par value
CMU - MFS Municipal Income Trust Common Stock
CNAV - Collaborative Investment Series Trust Mohr Company Nav ETF
CNBS - Amplify Seymour Cannabis ETF
CNET - ZW Data Action Technologies Inc. - Common Stock
CNL - Collective Mining Ltd. Common Shares
CNM - Core & Main, Inc. Class A Common Stock
CNOBP - ConnectOne Bancorp, Inc. - Depositary Shares (each representing a 1/40th interest in a share of 5.25% Fixed-Rate Reset Non-Cumulative Perpetual Preferred Stock, Series A, par value $0.00 per share)
CNSP - CNS Pharmaceuticals, Inc. - Common Stock
COAL - Exchange Traded Concepts Trust Range Global Coal Index ETF
COCP - Cocrystal Pharma, Inc. - Common Stock
COHN - Cohen & Company Inc.
COII - REX COIN Growth & Income ETF
COKE - Coca-Cola Consolidated, Inc. - Common Stock
COLB - Columbia Banking System, Inc. - Common Stock
CON - Concentra Group Holdings Parent, Inc. Common Stock
COOK - Traeger, Inc. Common Stock
COPL - Copley Acquisition Corp Ordinary Shares
COR - Cencora, Inc. Common Stock
COSM - Cosmos Health Inc. - Common Stock
COST - Costco Wholesale Corporation - Common Stock
CPA - Copa Holdings, S.A. Class A Common Stock
CPER - United States Copper Index Fund ETV
CPHI - China Pharma Holdings, Inc. Common Stock
CPNJ - Calamos ETF Trust Calamos Nasdaq - 100 Structured Alt Protection ETF -June
CPOP - Pop Culture Group Co., Ltd - Class A Ordinary Shares
CPRA - Calamos ETF Trust Calamos Russell 2000 Structured Alt Protection ETF - April
CPSS - Consumer Portfolio Services, Inc. - Common Stock
CRBG - Corebridge Financial Inc. Common Stock
CRBP - Corbus Pharmaceuticals Holdings, Inc. - Common Stock
CREVW - Carbon Revolution Public Limited Company - Warrant
CRK - Comstock Resources, Inc. Common Stock
CROX - Crocs, Inc. - Common Stock
CRSR - Corsair Gaming, Inc. - Common Stock
CRWD - CrowdStrike Holdings, Inc. - Class A Common Stock
CSAI - Cloudastructure, Inc. - Class A Common Stock
CSAN - Cosan S.A. ADS
CSB - VictoryShares US Small Cap High Div Volatility Wtd ETF
CSQ - Calamos Strategic Total Return Fund - Closed End Fund
CSWC - Capital Southwest Corporation - Common Stock
CTKB - Cytek Biosciences, Inc. - Common Stock
CTRN - Citi Trends, Inc. - Common Stock
CTSO - Cytosorbents Corporation - Common Stock
CUBB - Customers Bancorp, Inc 5.375% Subordinated Notes Due 2034
CUBE - CubeSmart Common Shares
CVSE - Morgan Stanley ETF Trust Calvert US Select Equity ETF
CVY - Invesco Zacks Multi-Asset Income ETF
CWAN - Clearwater Analytics Holdings, Inc. Class A Common Stock
CWB - SPDR Bloomberg Convertible Securities ETF
CXH - MFS Investment Grade Municipal Trust Common Stock
CYRX - CryoPort, Inc. - Common Stock
CZA - Invesco Zacks Mid-Cap ETF
D - Dominion Energy, Inc. Common Stock
DAKT - Daktronics, Inc. - Common Stock
DALN - DallasNews Corporation - Series A Common Stock
DAPP - VanEck Digital Transformation ETF
DATSW - DatChat, Inc. - Series A Warrant
DBMF - iMGP DBi Managed Futures Strategy ETF
DDEC - FT Vest U.S. Equity Deep Buffer ETF - December
DDOG - Datadog, Inc. - Class A Common Stock
DEED - First Trust Securitized Plus ETF
DEFR - ETF Series Solutions Aptus Deferred Income ETF
DFAE - Dimensional Emerging Core Equity Market ETF
DFAI - Dimensional International Core Equity Market ETF
DFCA - Dimensional ETF Trust Dimensional California Municipal Bond ETF
DFGX - Dimensional Global ex US Core Fixed Income ETF
DFII - First Trust Exchange-Traded Fund FT Vest Bitcoin Strategy & Target Income ETF
DFLV - Dimensional ETF Trust Dimensional US Large Cap Value ETF
DFND - Siren DIVCON Dividend Defender ETF
DFNM - Dimensional ETF Trust Dimensional National Municipal Bond ETF
DFSI - Dimensional ETF Trust Dimensional International Sustainability Core 1 ETF
DGRE - WisdomTree Emerging Markets Quality Dividend Growth Fund
DHI - D.R. Horton, Inc. Common Stock
DHSB - Strategy Shares Day Hagan Smart Buffer ETF
DHY - Credit Suisse High Yield Bond Fund Common Stock
DIBS - 1stdibs.com, Inc. - Common Stock
DJTWW - Trump Media & Technology Group Corp. - Warrants
DLNG - Dynagas LNG Partners LP Common Units
DLY - DoubleLine Yield Opportunities Fund Common Shares of Beneficial Interest
DMAA - Drugs Made In America Acquisition Corp. - Ordinary Shares
DMRC - Digimarc Corporation - Common Stock
DOCU - DocuSign, Inc. - Common Stock
DOLE - Dole plc Ordinary Shares
DOMH - Dominari Holdings Inc. - Common Stock
DOUG - Douglas Elliman Inc. Common Stock
DRH - Diamondrock Hospitality Company Common Stock
DRIV - Global X Autonomous & Electric Vehicles ETF
DRMA - Dermata Therapeutics, Inc. - Common Stock
DRRX - DURECT Corporation - Common Stock
DSTL - Distillate U.S. Fundamental Stability & Value ETF
DSU - Blackrock Debt Strategies Fund, Inc. Common Stock
DSWL - Deswell Industries, Inc. - Common Shares
DSYWW - Big Tree Cloud Holdings Limited - Warrants
DT - Dynatrace, Inc. Common Stock
DTCR - Global X Data Center & Digital Infrastructure ETF
DTD - WisdomTree U.S. Total Dividend Fund
DTEC - ALPS ETF Trust ALPS Disruptive Technologies ETF
DTF - DTF Tax-Free Income 2028 Term Fund Inc. Common Stock
DTM - DT Midstream, Inc. Common Stock 
DTSQ - DT Cloud Star Acquisition Corporation - Ordinary Shares
DTSS - Datasea Inc. - Common Stock
DTW - DTE Energy Company 2017 Series E 5.25% Junior Subordinated Debentures due 2077
DUSB - Dimensional ETF Trust Dimensional Ultrashort Fixed Income ETF
DVAL - BrandywineGLOBAL-Dynamic US Large Cap Value ETF
DVAX - Dynavax Technologies Corporation - Common Stock
DVLT - Datavault AI Inc. - Common Stock
DWSN - Dawson Geophysical Company - Common Stock
DXC - DXC Technology Company Common Stock 
DXCM - DexCom, Inc. - Common Stock
DYLD - LeaderShares Dynamic Yield ETF
DZZ - DB Gold Double Short ETN due February 15, 2038
EAF - GrafTech International Ltd. Common Stock
EAFG - Pacer Funds Trust Pacer Developed Markets Cash Cows Growth Leaders ETF
EATZ - AdvisorShares Restaurant ETF
EBAY - eBay Inc. - Common Stock
ECC - Eagle Point Credit Company Inc. Common Stock
ECLN - First Trust EIP Carbon Impact ETF
EDGF - The Advisors Inner Circle Fund II 3EDGE Dynamic Fixed Income ETF
EDGU - The Advisors Inner Circle Fund II 3EDGE Dynamic US Equity ETF
EDHL - Everbright Digital Holding Limited - Ordinary Shares
EDIV - SPDR S&P Emerging Markets Dividend ETF
EDN - Empresa Distribuidora Y Comercializadora Norte S.A. (Edenor) American Depositary Shares
EDV - Vanguard Extended Duration Treasury ETF
EEMV - iShares MSCI Emerging Markets Min Vol Factor ETF
EFAA - Invesco Actively Managed Exchange-Traded Fund Trus Invesco MSCI EAFE Income Advantage ETF
EFAS - Global X MSCI SuperDividend EAFE ETF
EFRA - iShares Environmental Infrastructure and Industrials ETF
EGBN - Eagle Bancorp, Inc. - Common Stock
EGO - Eldorado Gold Corporation Ordinary Shares
EGY - VAALCO Energy, Inc.  Common Stock
ELA - Envela Corporation Common Stock
ELMD - Electromed, Inc. Common Stock
ELON - Tidal Trust III Battleshares TSLA vs F ETF
ELPC - Companhia Paranaense de Energia (COPEL) American Depositary Shares (each representing four (4) Common Shares)
ELTX - Elicio Therapeutics, Inc. - Common Stock
ELUT - Elutia, Inc. - Class A Common Stock
EMBC - Embecta Corp. - Common Stock
EMCB - WisdomTree Emerging Markets Corporate Bond Fund
EMCGR - Embrace Change Acquisition Corp - Rights
EMD - Western Asset Emerging Markets Debt Fund Inc Common Stock
EME - EMCOR Group, Inc. Common Stock
EMLC - VanEck J. P. Morgan EM Local Currency Bond ET
EMOP - AB Active ETFs, Inc. AB Emerging Markets Opportunities ETF
EMX - EMX Royalty Corporation Common Shares (Canada)
ENB - Enbridge Inc Common Stock
ENTO - Entero Therapeutics Inc. - Common Stock
ENVX - Enovix Corporation - Common Stock
ENX - Eaton Vance New York Municipal Bond Fund Common Shares of Beneficial Interest, $.01 par value
EOD - Allspring Global Dividend Opportunity Fund Common Shares of Beneficial Interest
EOG - EOG Resources, Inc. Common Stock
EPOW - Sunrise New Energy Co., Ltd - Class A Ordinary Shares
EPRX - Eupraxia Pharmaceuticals Inc. - Common Stock
EPU - iShares MSCI Peru and Global Exposure ETF
EQIX - Equinix, Inc. - Common Stock
ERII - Energy Recovery, Inc. - Common Stock
ERJ - Embraer S.A. Common Stock
ERO - Ero Copper Corp. Common Shares
ESCA - Escalade, Incorporated - Common Stock
ESGR - Enstar Group Limited - Ordinary Shares
ESGU - iShares ESG Aware MSCI USA ETF
ESML - iShares ESG Aware MSCI USA Small-Cap ETF
ESN - Essential 40 Stock ETF
ESTC - Elastic N.V. Ordinary Shares
ETHT - ProShares Trust ProShares Ultra Ether ETF
ETHW - Bitwise Ethereum ETF Common shares of beneficial interest
ETX - Eaton Vance Municipal Income 2028 Term Trust Common Shares of Beneficial Interest
EURKU - Eureka Acquisition Corp - Unit
EVLVW - Evolv Technologies Holdings, Inc. - Warrant
EVNT - AltShares Event-Driven ETF
EVRG - Evergy, Inc. - Common Stock
EVT - Eaton Vance Tax Advantaged Dividend Income Fund Common Shares of Beneficial Interest
EVV - Eaton Vance Limited Duration Income Fund Common Shares of Beneficial Interest
EWBC - East West Bancorp, Inc. - Common Stock
EWH - iShares MSCI Hong Kong Index Fund
EWJ - iShares MSCI Japan Index Fund
EWL - iShares Inc iShares MSCI Switzerland ETF
EWM - iShares MSCI Malaysia Index Fund
EWTX - Edgewise Therapeutics, Inc. - Common Stock
EWU - iShares MSCI United Kingdom ETF
EWZS - iShares MSCI Brazil Small-Cap ETF
EXC - Exelon Corporation - Common Stock
EXPO - Exponent, Inc. - Common Stock
EYPT - EyePoint Pharmaceuticals, Inc. - Common Stock
F - Ford Motor Company Common Stock
FA - First Advantage Corporation - Common Stock
FAB - First Trust Multi Cap Value AlphaDEX Fund
FANG - Diamondback Energy, Inc. - Common Stock
FAST - Fastenal Company - Common Stock
FAUG - FT Vest U.S. Equity Buffer ETF - August
FBCV - Fidelity Blue Chip Value ETF
FBTC - Fidelity Wise Origin Bitcoin Fund Common Shares of Beneficial Interest
FBUF - Fidelity Dynamic Buffered Equity ETF
FDEM - Fidelity Emerging Markets Multifactor ETF
FDLO - Fidelity Low Volatility Factor ETF
FDRV - Fidelity Electric Vehicles and Future Transportation ETF
FE - FirstEnergy Corp. Common Stock
FEBP - PGIM S&P 500 Buffer 12 ETF - February
FELE - Franklin Electric Co., Inc. - Common Stock
FENC - Fennec Pharmaceuticals Inc. - Common Stock
FENI - Fidelity Covington Trust Fidelity Enhanced International ETF
FFOG - Franklin Templeton ETF Trust Franklin Focused Growth ETF
FFSM - Fidelity Fundamental Small-Mid Cap ETF
FGIWW - FGI Industries Ltd. - warrant
FGMC - FG Merger II Corp. - Common stock
FHB - First Hawaiian, Inc. - Common Stock
FIAT - Tidal Trust II YieldMax Short COIN Option Income Strategy ETF
FIAX - Tidal ETF Trust II Nicholas Fixed Income Alternative ETF
FIBK - First Interstate BancSystem, Inc. - Common Stock
FIGS - FIGS, Inc. Class A Common Stock
FINV - FinVolution Group American Depositary Shares
FISK - Empire State Realty OP, L.P. Series 250 Operating Partnership Units Representing Limited Partnership Interests
FISR - SPDR SSGA Fixed Income Sector Rotation ETF
FITBO - Fifth Third Bancorp - Depositary Shares each representing a 1/1000th ownership interest in a share of Non-Cumulative Perpetual Preferred Stock, Series K
FIXP - FolioBeyond Enhanced Fixed Income Premium ETF
FIXT - TCW ETF Trust TCW Core Plus Bond ETF
FLAX - Franklin FTSE Asia ex Japan ETF
FLCA - Franklin FTSE Canada ETF
FLCG - Federated Hermes ETF Trust Federated Hermes MDT Large Cap Growth ETF
FLDB - Fidelity Low Duration Bond ETF
FLDR - Fidelity Low Duration Bond Factor ETF
FLEX - Flex Ltd. - Ordinary Shares
FLGR - Franklin FTSE Germany ETF
FLGT - Fulgent Genetics, Inc. - Common Stock
FLHY - Franklin High Yield Corporate ETF
FLJH - Franklin FTSE Japan Hedged ETF
FLRG - Fidelity U.S. Multifactor ETF
FLRN - SPDR Bloomberg Investment Grade Floating Rate ETF
FLS - Flowserve Corporation Common Stock
FLTW - Franklin FTSE Taiwan ETF
FMAG - Fidelity Magellan ETF
FMAO - Farmers & Merchants Bancorp, Inc. - Common Stock
FMAT - Fidelity MSCI Materials Index ETF
FMB - First Trust Managed Municipal ETF
FMC - FMC Corporation Common Stock
FMCE - Northern Lights Fund Trust IV FM Compounders Equity ETF
FMNY - First Trust New York Municipal High Income ETF
FMS - Fresenius Medical Care AG American Depositary Shares (Each representing 1/2 of an Ordinary Share)
FMUN - Fidelity Systematic Municipal Bond Index ETF
FNK - First Trust Mid Cap Value AlphaDEX Fund
FNV - Franco-Nevada Corporation
FNX - First Trust Mid Cap Core AlphaDEX Fund
FOCT - FT Vest U.S. Equity Buffer ETF - October
FOLD - Amicus Therapeutics, Inc. - Common Stock
FOPC - The Advisors' Inner Circle Fund II Frontier Asset Opportunistic Credit ETF
FORA - Forian Inc. - Common Stock
FOXA - Fox Corporation - Class A Common Stock
FOXY - Simplify Exchange Traded Funds Simplify Currency Strategy ETF
FPA - First Trust Asia Pacific Ex-Japan AlphaDEX Fund
FPEI - First Trust Institutional Preferred Securities and Income ETF
FR - First Industrial Realty Trust, Inc. Common Stock
FRAF - Franklin Financial Services Corporation - Common Stock
FRHC - Freedom Holding Corp. - Common Stock
FRSH - Freshworks Inc. - Class A Common Stock
FSBD - Fidelity Merrimack Street Trust Fidelity Sustainable Core Plus Bond ETF
FSGS - First Trust SMID Growth Strength ETF
FSMB - First Trust Short Duration Managed Municipal ETF
FTAI - FTAI Aviation Ltd. - Common Stock
FTGS - First Trust Growth Strength ETF
FTI - TechnipFMC plc Ordinary Share
FTQI - First Trust Nasdaq BuyWrite Income ETF
FTV - Fortive Corporation Common Stock 
FTXG - First Trust Nasdaq Food & Beverage ETF
FULT - Fulton Financial Corporation - Common Stock
FUNL - CornerCap Fundametrics Large-Cap ETF
FUSI - American Century ETF Trust American Century Multisector Floating Income ETF
FV - First Trust Dorsey Wright Focus 5 ETF
FWONA - Liberty Media Corporation - Series A Liberty Formula One Common Stock
FWONK - Liberty Media Corporation - Series C Liberty Formula One Common Stock
FWRD - Forward Air Corporation - Common Stock
FXED - Sound Enhanced Fixed Income ETF
FXG - First Trust Cons. Staples AlphaDEX
GAMR - Amplify Video Game Leaders ETF
GAP - Gap, Inc. (The) Common Stock
GDDY - GoDaddy Inc. Class A Common Stock
GDEN - Golden Entertainment, Inc. - Common Stock
GDV - Gabelli Dividend & Income Trust Common Shares of Beneficial Interest
GDXJ - VanEck Junior Gold Miners ETF
GECCO - Great Elm Capital Corp. - 5.875% Notes due 2026
GEME - Pacific North of South EM Equity Active ETF
GENI - Genius Sports Limited Ordinary Shares
GENK - GEN Restaurant Group, Inc. - Class A Common Stock
GENT - Spinnaker ETF Series Genter Capital Taxable Quality Intermediate ETF
GENW - Spinnaker ETF Series Genter Capital International Dividend ETF
GEOS - Geospace Technologies Corporation - Common Stock
GES - Guess?, Inc. Common Stock
GETY - Getty Images Holdings, Inc. Class A Common Stock
GEV - GE Vernova Inc. Common Stock
GFS - GlobalFoundries Inc. - Ordinary Share
GGB - Gerdau S.A. Common Stock
GGLS - Direxion Daily GOOGL Bear 1X Shares
GHM - Graham Corporation Common Stock
GHYB - Goldman Sachs Access High Yield Corporate Bond ETF
GIFT - Giftify, Inc. - Common Stock
GIII - G-III Apparel Group, LTD. - Common Stock
GJR - Synthetic Fixed-Income Securities, Inc. STRATS Trust for Procter&Gamble Securities, Series 2006-1
GLBS - Globus Maritime Limited - Common Stock
GLDD - Great Lakes Dredge & Dock Corporation - Common Stock
GLOF - iShares Global Equity Factor ETF
GMEU - ETF Opp Tr T-REX 2X Long GME Daily Target ETF
GMMF - BlackRock ETF Trust iShares Government Money Market ETF
GMOM - Cambria Global Momentum ETF
GMS - GMS Inc. Common Stock
GNLN - Greenlane Holdings, Inc. - Class A Common Stock
GNOV - FT Vest U.S. Equity Moderate Buffer ETF - November
GOCO - GoHealth, Inc. - Class A Common Stock
GOEX - Global X Gold Explorers ETF
GOF - Guggenheim Strategic Opportunities Fund Common Shares of Beneficial Interest
GOLY - Strategy Shares Gold Enhanced Yield ETF
GOOD - Gladstone Commercial Corporation - Real Estate Investment Trust
GOOP - Kurv Yield Premium Strategy Google (GOOGL) ETF
GOOS - Canada Goose Holdings Inc. Subordinate Voting Shares
GOSS - Gossamer Bio, Inc. - Common Stock
GPIX - Goldman Sachs S&P 500 Premium Income ETF
GPRK - Geopark Ltd Common Shares
GPZ - VanEck ETF Trust VanEck Alternative Asset Manager ETF
GQI - Natixis ETF Trust Natixis Gateway Quality Income ETF
GQRE - FlexShares Global Quality Real Estate Index Fund
GS - Goldman Sachs Group, Inc. (The) Common Stock
GSIB - Themes Global Systemically Important Banks ETF
GSJY - Goldman Sachs ActiveBeta Japan Equity ETF
GSM - Ferroglobe PLC - Ordinary Shares
GSRT - GSR III Acquisition Corp. - Ordinary Shares
GT - The Goodyear Tire & Rubber Company - Common Stock
GTEK - Goldman Sachs Future Tech Leaders Equity ETF
GTENW - Gores Holdings X, Inc. - Warrants
GTIP - Goldman Sachs Access Inflation Protected USD Bond ETF
GTR - WisdomTree Target Range Fund
GURE - Gulf Resources, Inc. - Common Stock
HAIN - The Hain Celestial Group, Inc. - Common Stock
HAP - VanEck Natural Resources ETF
HAPI - Harbor Human Capital Factor US Large Cap ETF
HBANL - Huntington Bancshares Incorporated - Depositary Shares, Each Representing a 1/40th Interest in a Share of 6.875% Series J Non-Cumulative Perpetual Preferred Stock
HBI - Hanesbrands Inc. Common Stock
HBNC - Horizon Bancorp, Inc. - Common Stock
HCA - HCA Healthcare, Inc. Common Stock
HCSG - Healthcare Services Group, Inc. - Common Stock
HCXY - Hercules Capital, Inc. 6.25% Notes due 2033
HDGE - Ranger Equity Bear Bear ETF
HDSN - Hudson Technologies, Inc. - Common Stock
HECO - SPDR Galaxy Hedged Digital Asset Ecosystem ETF
HEPS - D-Market Electronic Services & Trading - American Depositary Shares
HERD - Pacer Cash Cows Fund of Funds ETF
HF - DGA Core Plus Absolute Return ETF
HFRO - Highland Opportunities and Income Fund Common Shares of Beneficial Interest
HIBL - Direxion Daily S&P 500 High Beta Bull 3X Shares
HIDE - Alpha Architect High Inflation and Deflation ETF
HII - Huntington Ingalls Industries, Inc. Common Stock
HIMS - Hims & Hers Health, Inc. Class A Common Stock
HIMZ - Defiance Daily Target 2X Long HIMS ETF
HIO - Western Asset High Income Opportunity Fund, Inc. Common Stock
HKD - AMTD Digital Inc. American Depositary Shares (every five of which represent two Class A Ordinary Shares)
HLNE - Hamilton Lane Incorporated - Class A Common Stock
HMC - Honda Motor Company, Ltd. Common Stock
HMN - Horace Mann Educators Corporation Common Stock
HNDL - Strategy Shares Nasdaq 7HANDL Index ETF
HNGE - Hinge Health, Inc. Class A Common Stock
HOFT - Hooker Furnishings Corporation - Common Stock
HOMZ - Hoya Capital Housing ETF
HONDU - HCM II Acquisition Corp. - Unit
HOOD - Robinhood Markets, Inc. - Class A Common Stock
HOOG - Leverage Shares 2X Long HOOD Daily ETF
HOOX - Defiance Daily Target 2X Long HOOD ETF
HPK - HighPeak Energy, Inc. - Common Stock
HRL - Hormel Foods Corporation Common Stock
HSDT - Helius Medical Technologies, Inc. - Class A Common Stock
HTGC - Hercules Capital, Inc. Common Stock
HTO - H2O America  - Common Stock
HUBG - Hub Group, Inc. - Class A Common Stock
HUBS - HubSpot, Inc. Common Stock
HUSV - First Trust Exchange-Traded Fund III First Trust Horizon Managed Volatility Domestic ETF
HUT - Hut 8 Corp. - Common Stock
HVAC - AdvisorShares Trust AdvisorShares HVAC and Industrials ETF
HWH - HWH International Inc. - Common Stock
HXHX - Haoxin Holdings Limited - Class A Ordinary Shares
HXL - Hexcel Corporation Common Stock
HYD - VanEck ETF Trust VanEck High Yield Muni ETF
HYGI - iShares U.S. ETF Trust iShares Inflation Hedged High Yield Bond ETF
HYPR - Hyperfine, Inc.  - Class A Common Stock
HYT - Blackrock Corporate High Yield Fund, Inc. Common Stock
HYXU - iShares International High Yield Bond ETF
IAGG - iShares International Aggregate Bond Fund
IAPR - Innovator International Developed Power Buffer ETF  April
IAS - Integral Ad Science Holding Corp. - Common Stock
IBCP - Independent Bank Corporation - Common Stock
IBDV - iShares iBonds Dec 2030 Term Corporate ETF
IBDW - iShares iBonds Dec 2031 Term Corporate ETF
IBDZ - iShares Trust iShares iBonds Dec 2034 Term Corporate ETF
IBEX - IBEX Limited - Common Share
IBHJ - iShares Trust iShares iBonds 2030 Term High Yield and Income ETF
IBIC - iShares Trust iShares iBonds Oct 2026 Term TIPS ETF
IBID - iShares Trust iShares iBonds Oct 2027 Term TIPS ETF
IBIJ - iShares Trust iShares iBonds Oct 2033 Term TIPS ETF
IBMN - iShares iBonds Dec 2025 Term Muni Bond ETF
IBMQ - iShares iBonds Dec 2028 Term Muni Bond ETF
IBMT - iShares Trust iShares iBonds Dec 2031 Term Muni Bond ETF
IBTA - Ibotta, Inc. Class A Common Stock
IBTL - iShares iBonds Dec 2031 Term Treasury ETF
IDVO - Amplify CWP International Enhanced Dividend Income ETF
IEQ - Lazard Active ETF Trust Lazard International Dynamic Equity ETF
IESC - IES Holdings, Inc. - Common Stock
IEV - iShares Europe ETF
IFEB - Innovator ETFs Trust Innovator International Developed Power Buffer ETF  February
IFS - Intercorp Financial Services Inc. Common Shares
IFV - First Trust Dorsey Wright International Focus 5 ETF
IGD - Voya Global Equity Dividend and Premium Opportunity Fund
IGOV - iShares International Treasury Bond ETF
IHD - Voya Emerging Markets High Income Dividend Equity Fund Common Shares
IIIN - Insteel Industries, Inc. Common Stock
IIM - Invesco Value Municipal Income Trust Common Stock
IINN - Inspira Technologies Oxy B.H.N. Ltd. - Ordinary Shares
IJH - iShares Core S&P Mid-Cap ETF
IMCR - Immunocore Holdings plc - American Depositary Shares
IMO - Imperial Oil Limited Common Stock
IMOS - ChipMOS TECHNOLOGIES INC. - American Depositary Shares
INAB - IN8bio, Inc. - Common Stock
INDH - WisdomTree India Hedged Equity Fund
INDV - Indivior PLC - Ordinary Shares
INDY - iShares India 50 ETF
INFA - Informatica Inc. Class A Common Stock
INFL - Horizon Kinetics Inflation Beneficiaries ETF
INFO - Harbor ETF Trust Harbor PanAgora Dynamic Large Cap Core ETF
INM - InMed Pharmaceuticals Inc. - Common Shares
INMU - iShares Intermediate Muni Income Active ETF
INO - Inovio Pharmaceuticals, Inc. - Common Stock
INQQ - INQQ The India Internet ETF
INSP - Inspire Medical Systems, Inc. Common Stock
INTC - Intel Corporation - Common Stock
INUV - Inuvo, Inc.
ION - ProShares Trust ProShares S&P Global Core Battery Metals ETF
IONS - Ionis Pharmaceuticals, Inc. - Common Stock
IOR - Income Opportunity Realty Investors, Inc. Common Stock
IP - International Paper Company Common Stock
IPAR - Interparfums, Inc. - Common Stock
IPKW - Invesco International BuyBack Achievers ETF
IPO - Renaissance IPO ETF
IPODW - Dune Acquisition Corporation II - Warrants
IQI - Invesco Quality Municipal Income Trust Common Stock
IQQQ - ProShares Nasdaq-100 High Income ETF
IRD - Opus Genetics, Inc. - Common Stock
IRTC - iRhythm Technologies, Inc. - Common Stock
ISVL - iShares Trust iShares International Developed Small Cap Value Factor ETF
ISWN - Amplify BlackSwan ISWN ETF
ITDI - iShares Trust iShares LifePath Target Date 2065 ETF
ITP - IT Tech Packaging, Inc. Common Stock
ITRG - Integra Resources Corp. Common Shares
ITRI - Itron, Inc. - Common Stock
ITRN - Ituran Location and Control Ltd. - Ordinary Shares
IVES - Wedbush Series Trust Dan IVES Wedbush AI Revolution ETF
IVOG - Vanguard S&P Mid-Cap 400 Growth ETF
IVP - Inspire Veterinary Partners, Inc. - Class A Common Stock
IVRS - iShares Trust iShares Future Metaverse Tech and Communications ETF
IVVM - BlackRock ETF Trust II iShares Large Cap Moderate Buffer ETF
IVZ - Invesco Ltd Common Stock
IWFG - NYLI Winslow Focused Large Cap Growth ETF
IWMY - Defiance R2000 Enhanced Options & 0DTE Income ETF
IWR - iShares Russell Mid-Cap ETF
IWTR - iShares MSCI Water Management Multisector ETF
IXC - iShares Global Energy ETF
IXHL - Incannex Healthcare Inc. - Common Stock
IYY - iShares Dow Jones U.S. ETF
JANU - AIM ETF Products Trust AllianzIM U.S. Equity Buffer15 Uncapped Jan ETF
JBI - Janus International Group, Inc. Common Stock
JBSS - John B. Sanfilippo & Son, Inc. - Common Stock
JCPB - JPMorgan Core Plus Bond ETF
JCSE - JE Cleantech Holdings Limited - Ordinary Shares
JCTR - JPMorgan Carbon Transition U.S. Equity ETF
JDIV - J.P. Morgan Exchange-Traded Fund Trust JPMorgan Dividend Leaders ETF
JETS - U.S. Global Jets ETF
JFU - 9F Inc. - American Depositary Shares
JHML - John Hancock Multifactor Large Cap ETF
JHMM - John Hancock Multifactor Mid Cap ETF
JMHI - J.P. Morgan Exchange-Traded Fund Trust JPMorgan High Yield Municipal ETF
JMM - Nuveen Multi-Market Income Fund (MA)
JMOM - JPMorgan U.S. Momentum Factor ETF
JOE - St. Joe Company (The) Common Stock
JOET - Virtus ETF Trust II Virtus Terranova U.S. Quality Momentum ETF
JPRE - J.P. Morgan Exchange-Traded Fund Trust JPMorgan Realty Income ETF
JSCP - JPMorgan Short Duration Core Plus ETF
JSPR - Jasper Therapeutics, Inc. - Class A Common Stock
JSTC - Adasina Social Justice All Cap Global ETF
JULQ - Innovator ETFs Trust Innovator Premium Income 40 Barrier ETF - July
JULW - AllianzIM U.S. Large Cap Buffer20 Jul ETF
JUNS - Jupiter Neurosciences, Inc. - Common Stock
KBDC - Kayne Anderson BDC, Inc. Common Stock
KBE - SPDR S&P Bank ETF
KBWB - Invesco KBW Bank ETF
KEMX - KraneShares MSCI Emerging Markets ex China Index ETF
KEUA - KraneShares European Carbon Allowance Strategy ETF
KFIIR - K&F Growth Acquisition Corp. II - Rights
KG - Kestrel Group, Ltd. - Common Stock
KJUL - Innovator U.S. Small Cap Power Buffer ETF - July
KLRS - Kalaris Therapeutics, Inc.  - Common Stock
KLXE - KLX Energy Services Holdings, Inc.  - Common Stock
KLXY - KraneShares Trust KraneShares Global Luxury Index ETF
KMAR - Innovator ETFs Trust Innovator U.S. Small Cap Power Buffer ETF - March
KMLM - KraneShares Mount Lucas Managed Futures Index Strategy ETF
KMX - CarMax Inc
KNGZ - First Trust S&P 500 Diversified Dividend Aristocrats ETF
KNOP - KNOT Offshore Partners LP Common Units representing Limited Partner Interests
KNSL - Kinsale Capital Group, Inc. Common Stock
KOID - KraneShares Global Humanoid and Embodied Intelligence Index ETF
KR - Kroger Company (The) Common Stock
KRE - SPDR S&P Regional Banking ETF
KRKR - 36Kr Holdings Inc. - American Depositary Shares
KRMN - Karman Holdings Inc. Common Stock
KROS - Keros Therapeutics, Inc. - common stock
KTH - Structures Products Cp 8% CorTS Issued by Peco Energy Cap Tr II Preferred Stock
KTN - Structured Products Corp 8.205% CorTS 8.205% Corporate Backed Trust Securities (CorTS)
KVACU - Keen Vision Acquisition Corporation - Units
KVYO - Klaviyo, Inc. Series A Common Stock
LABD - Direxion Daily S&P Biotech Bear 3X Shares
LAMR - Lamar Advertising Company - Class A Common Stock
LANDP - Gladstone Land Corporation - 6.00% Series C Cumulative Redeemable Preferred Stock
LAZR - Luminar Technologies, Inc.  - Class A Common Stock
LCCCU - Lakeshore Acquisition III Corp. - Unit
LCID - Lucid Group, Inc. - Common Stock
LCR - Managed Portfolio Series Leuthold Core ETF
LDRH - iShares Trust iShares iBonds 1-5 Year High Yield  and Income Ladder ETF
LDWY - Lendway, Inc. - Common Stock
LEE - Lee Enterprises, Incorporated - Common Stock
LEMB - iShares J.P. Morgan EM Local Currency Bond
LEXX - Lexaria Bioscience Corp. - Common Stock
LFAE - LifeX 2048 Longevity Income ETF
LFAK - LifeX 2052 Longevity Income ETF
LFAV - LifeX 2059 Longevity Income ETF
LFSC - F/m Emerald Life Sciences Innovation ETF
LGHL - Lion Group Holding Ltd. - American Depositary Share
LI - Li Auto Inc. - American Depositary Shares
LIAF - LifeX 2051 Inflation-Protected Longevity Income ETF
LIAP - LifeX 2057 Inflation-Protected Longevity Income ETF
LIAU - LifeX 2060 Inflation-Protected Longevity Income ETF
LIMI - Themes ETF Trust Themes Lithium & Battery Metal Miners ETF
LKOR - FlexShares Trust FlexShares Credit-Scored US Long Corporate Bond Index Fund
LMBO - Direxion Shares ETF Trust Direxion Daily Crypto Industry Bull 2X Shares
LNKB - LINKBANCORP, Inc. - Common Stock
LNTH - Lantheus Holdings, Inc. - Common Stock
LOWV - AB Active ETFs, Inc. AB US Low Volatility Equity ETF
LPA - Logistic Properties of the Americas Ordinary Shares
LPAAW - Launch One Acquisition Corp. - Warrant
LPTX - Leap Therapeutics, Inc. - Common Stock
LQDA - Liquidia Corporation - Common Stock
LRE - Lead Real Estate Co., Ltd - American Depositary Shares
LRHC - La Rosa Holdings Corp. - Common Stock
LRMR - Larimar Therapeutics, Inc. - Common Stock
LSAT - LeaderShares AlphaFactor Tactical Focused ETF
LTBR - Lightbridge Corporation - Common Stock
LTH - Life Time Group Holdings, Inc. Common Stock
LUXE - LuxExperience B.V. American Depositary Shares, each representing one Ordinary Share
LVHD - Franklin U.S. Low Volatility High Dividend Index ETF
LXEO - Lexeo Therapeutics, Inc. - Common Stock
LYB - LyondellBasell Industries NV Ordinary Shares Class A (Netherlands)
LZ - LegalZoom.com, Inc. - Common Stock
LZMH - LZ Technology Holdings Limited - Class B Ordinary Shares
MACI - Melar Acquisition Corp. I - Class A Ordinary Shares
MAGA - Point Bridge America First ETF
MAGN - Magnera Corporation Common Stock
MAIN - Main Street Capital Corporation Common Stock
MAMA - Mama's Creations, Inc. - Common Stock
MAR - Marriott International - Class A Common Stock
MARA - MARA Holdings, Inc. - Common Stock
MART - AIM ETF Products Trust AllianzIM U.S. Large Cap Buffer10 Mar ETF
MASI - Masimo Corporation - Common Stock
MASK - 3 E Network Technology Group Ltd - Class A Ordinary Shares
MASS - 908 Devices Inc. - Common Stock
MAT - Mattel, Inc. - Common Stock
MATV - Mativ Holdings, Inc. Common Stock
MBAV - M3-Brigade Acquisition V Corp. - Class A Ordinary shares
MBC - MasterBrand, Inc. Common Stock
MBSX - Advisor Managed Portfolios Regan Fixed Rate MBS ETF
MCFT - MasterCraft Boat Holdings, Inc. - Common Stock
MDGL - Madrigal Pharmaceuticals, Inc. - Common Stock
MDRR - Medalist Diversified REIT, Inc. - Common Stock
MDY - SPDR S&P MidCap 400 ETF Trust
MELI - MercadoLibre, Inc. - Common Stock
MERC - Mercer International Inc. - Common Stock
METV - Roundhill Ball Metaverse ETF
MFAO - MFA Financial, Inc. 9.000% Senior Notes due 2029
MFDX - PIMCO Equitiy Series PIMCO RAFI Dynamic Multi-Factor International Equity ETF
MFH - Mercurity Fintech Holding Inc. - American Ordinary Shares
MFM - MFS Municipal Income Trust Common Stock
MFSV - MFS Active Exchange Traded Funds Trust MFS Active Value ETF
MFUT - Tidal Trust II Cambria Chesapeake Pure Trend ETF
MGRC - McGrath RentCorp - Common Stock
MID - American Century Mid Cap Growth Impact ETF
MIDE - Xtrackers S&P MidCap 400 Scored & Screened ETF
MILN - Global X Millennial Consumer ETF
MIND - MIND Technology, Inc. - Common Stock
MKDW - MKDWELL Tech Inc. - Ordinary Shares
MKDWW - MKDWELL Tech Inc. - Warrants
MKTX - MarketAxess Holdings, Inc. - Common Stock
MLCO - Melco Resorts & Entertainment Limited - American Depositary Shares 
MLDR - Global X Funds Global X Intermediate-Term Treasury Ladder ETF
MLI - Mueller Industries, Inc. Common Stock
MLYS - Mineralys Therapeutics, Inc. - Common Stock
MMCA - NYLI MacKay California Muni Intermediate ETF
MMIN - NYLI MacKay Muni Insured ETF
MMSC - First Trust Multi-Manager Small Cap Opportunities ETF
MMSD - New York Life Investments Active ETF Trust NYLI MacKay Muni Short Duration ETF
MNPR - Monopar Therapeutics Inc. - Common Stock
MNTL - Tema Neuroscience and Mental Health ETF
MNY - MoneyHero Limited - Class A Ordinary Shares
MOB - Mobilicom Limited - American Depositary Shares
MOBXW - Mobix Labs, Inc. - Warrants
MP - MP Materials Corp. Common Stock
MPB - Mid Penn Bancorp - Common Stock
MPU - Mega Matrix Inc. Class A Ordinary Shares
MRCC - Monroe Capital Corporation - Closed End Fund
MRCY - Mercury Systems Inc - Common Stock
MRGR - ProShares Merger ETF
MRSN - Mersana Therapeutics, Inc. - Common Stock
MSDL - Morgan Stanley Direct Lending Fund Common Stock
MSFO - Tidal ETF Trust II YieldMax MSFT Option Income Strategy ETF
MSFX - ETF Opportunities Trust T-Rex 2X Long Microsoft Daily Target ETF
MSGE - Madison Square Garden Entertainment Corp. Class A Common Stock
MSPR - MSP Recovery, Inc. - Class A Common Stock
MSTY - Tidal Trust II YieldMax MSTR Option Income Strategy ETF
MTH - Meritage Homes Corporation Common Stock
MTRN - Materion Corporation
MTSR - Metsera, Inc. - Common Stock
MUA - Blackrock MuniAssets Fund, Inc Common Stock
MUR - Murphy Oil Corporation Common Stock
MUX - McEwen Mining Inc. Common Stock
MVIS - MicroVision, Inc. - Common Stock
MVLL - GraniteShares 2x Long MRVL Daily ETF
MVSTW - Microvast Holdings, Inc. - Warrant
MVV - ProShares Ultra MidCap400
MYI - Blackrock MuniYield Quality Fund III, Inc Common Stock
MYY - ProShares Short MidCap400
NAAS - NaaS Technology Inc. - American Depositary Shares
NACP - Impact Shares Trust I Impact Shares NAACP Minority Empowerment ETF
NAMM - Namib Minerals - Ordinary Shares
NAMMW - Namib Minerals - Warrants
NAN - Nuveen New York Quality Municipal Income Fund Common Stock
NAZ - Nuveen Arizona Quality Municipal Income Fund Common Stock
NBET - Neuberger Berman Energy Transition & Infrastructure ETF
NBH - Neuberger Berman Municipal Fund Inc. Common Stock
NBTB - NBT Bancorp Inc. - Common Stock
NCI - Neo-Concept International Group Holdings Limited - Class A Ordinary Shares
NCMI - National CineMedia, Inc. - Common Stock
NCPB - Nuveen Core Plus Bond ETF
NCZ - Virtus Convertible & Income Fund II Common Shares of Beneficial Interest
NESRW - National Energy Services Reunited Corp - Warrants
NETDU - Nabors Energy Transition Corp. II - Unit
NEUP - Neuphoria Therapeutics Inc. - Common Stock
NEWT - NewtekOne, Inc. - Common Stock
NFG - National Fuel Gas Company Common Stock
NFGC - New Found Gold Corp Common Shares
NFLY - Tidal ETF Trust II YieldMax NFLX Option Income Strategy ETF
NG - Novagold Resources Inc.
NHC - National HealthCare Corporation Common Stock
NHI - National Health Investors, Inc. Common Stock
NHPBP - National Healthcare Properties, Inc. - 7.125% Series B Cumulative Redeemable Perpetual Preferred Stock
NIC - Nicolet Bankshares Inc. Common Stock
NIOBW - NioCorp Developments Ltd. - Warrant
NISN - NiSun Intl Enterprise Development Group Co, Ltd - Class A Common Shares
NIU - Niu Technologies - American Depositary Shares
NIXT - Research Affiliates Deletions ETF
NJAN - Innovator Growth-100 Power Buffer ETF - January
NKX - Nuveen California AMT-Free Quality Municipal Income Fund
NLSPW - NLS Pharmaceutics Ltd. - Warrant
NMZ - Nuveen Municipal High Income Opportunity Fund Common Stock, $0.01 par value, per share
NNNN - Anbio Biotechnology - Class A Ordinary Shares
NNOV - Innovator ETFs Trust Innovator Growth-100 Power Buffer ETF - November
NNVC - NanoViricides, Inc. Common Stock
NOEMR - CO2 Energy Transition Corp. - Right
NOEMW - CO2 Energy Transition Corp. - Warrant
NRES - Xtrackers RREEF Global Natural Resources ETF
NRG - NRG Energy, Inc. Common Stock
NSPR - InspireMD Inc. - Common Stock
NSTS - NSTS Bancorp, Inc. - Common Stock
NTAP - NetApp, Inc. - Common Stock
NTGR - NETGEAR, Inc. - Common Stock
NTRA - Natera, Inc. - Common Stock
NUSA - Nuveen ESG 1-5 Year U.S. Aggregate Bond ETF
NUV - Nuveen Municipal Value Fund, Inc. Common Stock
NVA - Nova Minerals Limited - American Depositary Shares
NVBW - AIM ETF Products Trust AllianzIM U.S. Large Cap Buffer20 Nov ETF
NVDY - Tidal ETF Trust II YieldMax NVDA Option Income Strategy ETF
NVG - Nuveen AMT-Free Municipal Credit Income Fund 
NWSA - News Corporation - Class A Common Stock
NXGL - NexGel, Inc - Common Stock
NXL - Nexalin Technology, Inc. - Common Stock
NXP - Nuveen Select Tax Free Income Portfolio Common Stock
NXPL - NextPlat Corp - Common Stock
NXTT - Next Technology Holding Inc. - Ordinary Shares
NYAX - Nayax Ltd. - Ordinary Shares
NYMTI - New York Mortgage Trust, Inc. - 9.125% Senior Notes Due 2029
NYXH - Nyxoah SA - Ordinary Shares
NZUS - SPDR MSCI USA Climate Paris Aligned ETF
OAEM - Unified Series Trust OneAscent Emerging Markets ETF
OARK - YieldMax Innovation Option Income Strategy ETF
OBIL - US Treasury 12 Month Bill ETF
OBK - Origin Bancorp, Inc. Common Stock
OBT - Orange County Bancorp, Inc. - Common Stock
OFIX - Orthofix Medical Inc.  - Common Stock
OGN - Organon & Co. Common Stock 
OHI - Omega Healthcare Investors, Inc. Common Stock
OIH - VanEck Oil Services ETF
OLN - Olin Corporation Common Stock
OLO - Olo Inc. Class A Common Stock
OMAB - Grupo Aeroportuario del Centro Norte S.A.B. de C.V. - American Depositary Shares each representing 8 Series B shares
OMCC - Old Market Capital Corporation - Common Stock
OMDA - Omada Health, Inc. - Common Stock
OMFS - Invesco Exchange-Traded Self-Indexed Fund Trust Invesco Russell 2000 Dynamic Multifactor ETF
ONEQ - Fidelity Nasdaq Composite Index ETF
ONFOW - Onfolio Holdings Inc. - Warrant
ONIT - Onity Group Inc. Common Stock
ONLN - ProShares Online Retail ETF
ONOF - Global X Adaptive U.S. Risk Management ETF
OOSB - One One S&P 500 and Bitcoin ETF
OPAD - Offerpad Solutions Inc. Class A Common Stock
OPK - Opko Health, Inc. - Common Stock
OPTZ - Optimize Strategy Index ETF
OPY - Oppenheimer Holdings, Inc. Class A Common Stock (DE)
ORCX - Defiance Daily Target 2X Long ORCL ETF
OSPN - OneSpan Inc. - Common Stock
OTEX - Open Text Corporation - Common Shares
OXLCL - Oxford Lane Capital Corp. - 6.75% Notes due 2031
OXLCP - Oxford Lane Capital Corp. - 6.25% Series 2027 Term Preferred Shares
OXSQ - Oxford Square Capital Corp. - Closed End Fund
OXSQG - Oxford Square Capital Corp. - 5.50% Notes due 2028
OXY - Occidental Petroleum Corporation Common Stock
PAC - Grupo Aeroportuario Del Pacifico, S.A. B. de C.V. Grupo Aeroportuario Del Pacifico, S.A. de C.V. (each representing 10 Series B shares)
PAGP - Plains GP Holdings, L.P. - Class A Shares representing limited partner interests
PALC - Pacer Lunt Large Cap Multi-Factor Alternator ETF
PANG - Leverage Shares 2X Long PANW Daily ETF
PAYX - Paychex, Inc. - Common Stock
PBAU - PGIM S&P 500 Buffer 20 ETF - August
PBFB - PGIM S&P 500 Buffer 20 ETF - February
PBHC - Pathfinder Bancorp, Inc. - Common Stock
PBPB - Potbelly Corporation - Common Stock
PBSE - PGIM S&P 500 Buffer 20 ETF - September
PBTP - Invesco 0-5 Yr US TIPS ETF
PC - Premium Catering (Holdings) Limited - Ordinary Shares
PCHI - FundVantage Trust Polen High Income ETF
PCMM - BondBloxx Private Credit CLO ETF
PCSA - Processa Pharmaceuticals, Inc. - Common Stock
PCTTW - PureCycle Technologies, Inc. - Warrant
PDCC - Pearl Diver Credit Company Inc. Common Stock
PEPG - PepGen Inc. - Common Stock
PFFL - ETRACS 2xMonthly Pay Leveraged Preferred Stock Index ETN due September 25, 2048
PFG - Principal Financial Group Inc - Common Stock
PG - Procter & Gamble Company (The) Common Stock
PGRE - Paramount Group, Inc. Common Stock
PGRO - Putnam Focused Large Cap Growth ETF
PHDG - Invesco S&P 500 Downside Hedged ETF
PHEQ - Morgan Stanley ETF Trust Parametric Hedged Equity ETF
PHH - Park Ha Biological Technology Co., Ltd. - ordinary shares
PHUN - Phunware, Inc. - Common Stock
PIIIW - P3 Health Partners Inc. - Warrant
PIO - Invesco Global Water ETF
PJAN - Innovator U.S. Equity Power Buffer ETF - January
PJP - Invesco Pharmaceuticals ETF
PKBK - Parke Bancorp, Inc. - Common Stock
PLTR - Palantir Technologies Inc. - Class A Common Stock
PLTW - Roundhill ETF Trust Roundhill PLTR WeeklyPay ETF
PLUR - Pluri Inc. - Common Stock
PLUS - ePlus inc. - Common Stock
PLYM - Plymouth Industrial REIT, Inc. Common Stock
PMAP - PGIM Rock ETF Trust PGIM S&P 500 Max Buffer ETF - April
PMMF - BlackRock ETF Trust iShares Prime Money Market ETF
PNQI - Invesco Nasdaq Internet ETF
POCI - Precision Optics Corporation, Inc. - Common stock
POCT - Innovator U.S. Equity Power Buffer ETF - October
PODD - Insulet Corporation - Common Stock
PONY - Pony AI Inc. - American Depositary Shares
POWI - Power Integrations, Inc. - Common Stock
POWWP - Outdoor Holding Company - 8.75% Series A Cumulative Redeemable Perpetual Preferred Stock
PPLT - abrdn Physical Platinum Shares ETF
PPTY - U.S. Diversified Real Estate ETF
PRENW - Prenetics Global Limited - Warrant
PRG - PROG Holdings, Inc. Common Stock
PRGO - Perrigo Company plc Ordinary Shares
PRN - Invesco Dorsey Wright Industrials Momentum ETF
PROK - ProKidney Corp. - Class A Ordinary Shares
PRT - PermRock Royalty Trust Trust Units
PRVA - Privia Health Group, Inc. - Common Stock
PRZO - ParaZero Technologies Ltd. - Ordinary Shares
PSCD - Invesco S&P SmallCap Consumer Discretionary ETF
PSCH - Invesco S&P SmallCap Health Care ETF
PSCX - Pacer Swan SOS Conservative (January) ETF
PSFM - Pacer Swan SOS Flex (April) ETF
PSMD - Pacer Swan SOS Moderate (January) ETF
PSTG - Pure Storage, Inc. Class A Common Stock
PSTL - Postal Realty Trust, Inc. Class A Common Stock
PTBD - Pacer Trendpilot US Bond ETF
PTCT - PTC Therapeutics, Inc. - Common Stock
PTLC - Pacer Fund Trust Pacer Trendpilot US Large Cap ETF
PWV - Invesco Large Cap Value ETF
PXE - Invesco Energy Exploration & Production ETF
PZA - Invesco National AMT-Free Municipal Bond ETFo
QAI - NYLI Hedge Multi-Strategy Tracker ETF
QARP - Xtrackers Russell 1000 US Quality at a Reasonable Price ETF ETF
QAT - iShares MSCI Qatar ETF
QBF - Innovator ETFs Trust Innovator Uncapped Bitcoin 20 Floor ETF - Quarterly
QCMD - Direxion Daily QCOM Bear 1X ETF
QCML - GraniteShares 2x Long QCOM Daily ETF
QDEL - QuidelOrtho Corporation - Common Stock
QDTE - Roundhill Innovation-100 0DTE Covered Call Strategy ETF
QETAU - Quetta Acquisition Corporation - Unit
QGEN - Qiagen N.V. Common Shares
QH - Quhuo Limited - American Depository Shares
QIG - WisdomTree U.S. Corporate Bond Fund
QJUN - FT Vest Nasdaq-100 Buffer ETF - June
QLTY - The 2023 ETF Series Trust II GMO U.S. Quality ETF
QLYS - Qualys, Inc. - Common Stock
QMFE - First Trust Exchange-Traded Fund VIII FT Vest Nasdaq-100 Moderate Buffer ETF - February
QMID - WisdomTree U.S. MidCap Quality Growth Fund
QNST - QuinStreet, Inc. - Common Stock
QOWZ - Invesco Nasdaq Free Cash Flow Achievers ETF
QQEW - First Trust NASDAQ-100 Equal Weighted Index Fund
QQJG - Invesco ESG NASDAQ Next Gen 100 ETF
QQQT - Defiance Nasdaq 100 Income Target ETF
QSG - QuantaSing Group Limited - American Depositary Shares
QTAP - Innovator Growth Accelerated Plus ETF - April
QUSA - Tidal Trust III VistaShares Target 15 USA Quality Income ETF
QUVU - Hartford Funds Exchange-Traded Trust Hartford Quality Value ETF
QVCGP - QVC Group, Inc. - 8.0% Fixed Rate Cumulative Redeemable Preferred Stock
QVML - Invesco S&P 500 QVM Multi-factor ETF
QWLD - SPDR MSCI World StrategicFactors ETF
QXQ - SGI Enhanced Nasdaq-100 ETF
RANG - Range Capital Acquisition Corp. - Ordinary Shares
RAY - Raytech Holding Limited - ordinary shares
RAYD - The Advisors' Inner Circle Fund III Rayliant Quantitative Developed Market Equity ETF
RBNE - Robin Energy Ltd. - Common Stock
RCKT - Rocket Pharmaceuticals, Inc. - Common Stock
RCMT - RCM Technologies, Inc. - Common Stock
RCT - RedCloud Holdings plc - Ordinary Shares
RDAG - Republic Digital Acquisition Company - Class A Ordinary Shares
RDNT - RadNet, Inc. - Common Stock
RDTE - Roundhill Russell 2000 0DTE Covered Call Strategy ETF
REAI - Intelligent Real Estate ETF
REIT - ALPS Active REIT ETF
REK - ProShares Short Real Estate
REKT - Direxion Shares ETF Trust Direxion Daily Crypto Industry Bear 1X Shares
REM - iShares Trust iShares Mortgage Real Estate ETF
REMX - VanEck Rare Earth and Strategic Metals ETF
RFAIU - RF Acquisition Corp II - Unit
RFL - Rafael Holdings, Inc. Class B Common Stock
RFMZ - RiverNorth Flexible Municipal Income Fund II, Inc. Common Stock
RGC - Regencell Bioscience Holdings Limited - Ordinary Shares
RGEF - Tidal Trust III Rockefeller Global Equity ETF
RGTI - Rigetti Computing, Inc.  - Common stock
RGTIW - Rigetti Computing, Inc.  - Redeemable warrants, each whole warrant exercisable for one Class A ordinary share at an exercise price of $11.50
RILA - Spinnaker ETF Series Indexperts Gorilla Aggressive Growth ETF
RILYZ - B. Riley Financial, Inc. - 5.25% Senior Notes due 2028
RINC - Investment Managers Series Trust II AXS Real Estate Income ETF
RIVN - Rivian Automotive, Inc. - Class A Common Stock
RJMG - First Trust Exchange-Traded Fund VIII FT Raymond James Multicap Growth Equity ETF
RLI - RLI Corp. Common Stock (DE)
RM - Regional Management Corp. Common Stock
RMBS - Rambus, Inc. - Common Stock
RMCF - Rocky Mountain Chocolate Factory, Inc. - Common Stock
RMNI - Rimini Street, Inc. - Common Stock
RNWZ - Listed Funds Trust TrueShares Eagle Global Renewable Energy Income ETF
ROPE - EA Series Trust Coastal Compass 100 ETF
RPD - Rapid7, Inc. - Common Stock
RRGB - Red Robin Gourmet Burgers, Inc. - Common Stock
RRR - Red Rock Resorts, Inc. - Class A Common Stock
RSEE - Collaborative Investment Series Trust Rareview Systematic Equity ETF
RSG - Republic Services, Inc. Common Stock
RSPU - Invesco S&P 500 Equal Weight Utilities ETF
RSSX - Tidal Trust II Return Stacked U.S. Stocks & Gold/Bitcoin ETF
RUNN - Running Oak Efficient Growth ETF
RVNU - Xtrackers Municipal Infrastructure Revenue Bond ETF
RVPH - Reviva Pharmaceuticals Holdings, Inc. - Common Stock
RVRB - Advisors Series Trust Reverb ETF
RVT - Royce Small-Cap Trust, Inc. Common Stock
RWO - SPDR DJ Wilshire Global Real Estate ETF
RXST - RxSight, Inc. - Common Stock
RYAM - Rayonier Advanced Materials Inc. Common Stock
RYTM - Rhythm Pharmaceuticals, Inc. - Common Stock
RZLVW - Rezolve AI PLC - Warrants
SA - Seabridge Gold, Inc. Ordinary Shares (Canada)
SAH - Sonic Automotive, Inc. Common Stock
SAM - Boston Beer Company, Inc. (The) Common Stock
SAWS - ETF Series Solutions AAM Sawgrass US Small Cap Quality Growth ETF
SBAR - Simplify Exchange Traded Funds Simplify Barrier Income ETF
SBFM - Sunshine Biopharma Inc. - Common stock
SBFMW - Sunshine Biopharma Inc. - Warrant
SBGI - Sinclair, Inc. - Class A Common Stock
SBIO - ALPS Medical Breakthroughs ETF
SBXD - SilverBox Corp IV Class A Ordinary Shares
SCC - ProShares UltraShort Consumer Discretionary
SCCG - Sachem Capital Corp. 8.00% Notes due 2027
SCDL - ETRACS 2x Leveraged US Dividend Factor TR ETN
SCEC - Capitol Series Trust Sterling Capital Enhanced Core Bond ETF
SCHD - Schwab US Dividend Equity ETF
SCHI - Schwab 5-10 Year Corporate Bond ETF
SCJ - iShares MSCI Japan Sm Cap
SCLX - Scilex Holding Company - Common Stock
SCM - Stellus Capital Investment Corporation Common Stock
SCO - ProShares UltraShort Bloomberg Crude Oil
SCVL - Shoe Carnival, Inc. - Common Stock
SDD - ProShares UltraShort SmallCap600
SDG - iShares MSCI Global Sustainable Development Goals ETF
SDGR - Schrodinger, Inc. - Common Stock
SDHIR - Siddhi Acquisition Corp - Right
SDOW - UltraPro Short Dow30
SDTY - YieldMax S&P 500 0DTE Covered Call Strategy ETF
SEED - Origin Agritech Limited - Ordinary Shares
SELV - SEI Enhanced Low Volatility U.S. Large Cap ETF
SEMI - Columbia Select Technology ETF
SETM - Sprott Critical Materials ETF
SFEB - First Trust Exchange-Traded Fund VIII FT Vest U.S. Small Cap Moderate Buffer ETF - February
SFWL - Shengfeng Development Limited - Class A Ordinary Shares
SFYX - SoFi Next 500 ETF
SG - Sweetgreen, Inc. Class A Common Stock
SGD - Safe and Green Development Corporation - Common Stock
SGLY - Singularity Future Technology Ltd. - Common Stock
SHDG - Trust For Advised Portfolios Soundwatch Hedged Equity ETF
SHOC - EA Series Trust Strive U.S. Semiconductor ETF
SHOP - Shopify Inc. - Class A Subordinate Voting Shares
SHPH - Shuttle Pharmaceuticals Holdings, Inc. - common stock
SIMA - SIM Acquisition Corp. I - Class A Ordinary Shares
SIMS - SPDR S&P Kensho Intelligent Structures ETF 
SINT - SiNtx Technologies, Inc. - Common Stock
SIXP - AIM ETF Products Trust AllianzIM U.S. Large Cap 6 Month Buffer10 Mar/Sep ETF
SIXS - ETC 6 Meridian Small Cap Equity ETF
SJB - ProShares Short High Yield
SJNK - SPDR Bloomberg Short Term High Yield Bond ETF
SKT - Tanger Inc. Common Stock
SKYU - ProShares Ultra Cloud Computing
SLAB - Silicon Laboratories, Inc. - Common Stock
SLDPW - Solid Power, Inc. - Warrant
SLE - Super League Enterprise, Inc. - Common Stock
SLNH - Soluna Holdings, Inc. - Common Stock
SLRC - SLR Investment Corp. - Closed End Fund
SLVP - iShares MSCI Global Silver Miners Fund
SLVR - Sprott Silver Miners & Physical Silver ETF
SLYV - SPDR S&P 600 Small Cap Value ETF (based on S&P SmallCap Value Index--symbol--CVK
SMA - SmartStop Self Storage REIT, Inc. Common Stock
SMAP - Amplify ETF Trust Amplify Small-Mid Cap Equity ETF
SMAY - FT Vest U.S. Small Cap Moderate Buffer ETF - May
SMCI - Super Micro Computer, Inc. - Common Stock
SMCO - Hilton Small-MidCap Opportunity ETF
SMDX - Tidal Trust III Intech S&P Small-Mid Cap Diversified Alpha ETF
SMHB - ETRACS Monthly Pay 2x Leveraged Small Cap High Dividend ETN Series B
SMN - ProShares UltraShort Materials
SMOG - VanEck Low Carbon Energy ETF
SMST - Defiance Daily Target 2x Short MSTR ETF
SMX - SMX (Security Matters) Public Limited Company - Class A Ordinary Shares
SMXWW - SMX (Security Matters) Public Limited Company - Warrant
SN - SharkNinja, Inc. Ordinary Shares
SNEX - StoneX Group Inc. - Common Stock
SNTG - Sentage Holdings Inc. - Class A Ordinary Shares
SOLZ - Solana ETF
SONN - Sonnet BioTherapeutics Holdings, Inc. - Common Stock
SOUN - SoundHound AI, Inc. - Class A Common Stock
SOXL - Direxion Daily Semiconductor Bull 3x Shares
SOXY - Tidal Trust II YieldMax Target 12 Semiconductor Option Income ETF
SPBO - SPDR Portfolio Corporate Bond ETF
SPFF - Global X SuperIncome Preferred ETF
SPKLU - Spark I Acquisition Corp. - Unit
SPMD - SPDR Portfolio S&P 400 Mid Cap ETF  
SPMO - Invesco S&P 500 Momentum ETF
SPR - Spirit Aerosystems Holdings, Inc. Common Stock
SPRU - Spruce Power Holding Corporation Class A Common Stock
SPSM - SPDR Portfolio S&P 600 Small Cap ETF
SPUC - Simplify Exchange Traded Funds Simplify US Equity PLUS Upside Convexity ETF
SPUS - SP Funds S&P 500 Sharia Industry Exclusions ETF
SPXC - SPX Technologies, Inc. Common Stock
SPXV - ProShares S&P 500 Ex-Health Care ETF
SPXX - Nuveen S&P 500 Dynamic Overwrite Fund
SPYT - Tidal Trust II Defiance S&P 500 Target Income ETF
SPYX - SPDR S&P 500 Fossil Fuel Reserves Free ETF
SQQQ - ProShares UltraPro Short QQQ
SRAD - Sportradar Group AG - Class A Ordinary Shares
SRBK - SR Bancorp, Inc. - Common stock
SRFM - Surf Air Mobility Inc. Common Stock
SRHQ - SRH U.S. Quality GARP ETF
SRHR - Elevation Series Trust SRH REIT Covered Call ETF
SRL - Scully Royalty Ltd.
SRM - SRM Entertainment, Inc. - Common Stock
SRXH - SRX Health Solutions, Inc. Common Stock
SRZN - Surrozen, Inc. - Common Stock
SSKN - Strata Skin Sciences, Inc. - Common Stock
SSY - SunLink Health Systems, Inc. Common Stock
STAI - ScanTech AI Systems Inc. - Common stock
STAX - Macquarie ETF Trust Macquarie Tax-Free USA Short Term ETF
STBF - Trust for Professional Managers Performance Trust Short Term Bond ETF
STEL - Stellar Bancorp, Inc. Common Stock
STFS - Star Fashion Culture Holdings Limited - Class A Ordinary Shares
STIM - Neuronetics, Inc. - Common Stock
STM - STMicroelectronics N.V. Common Stock
STN - Stantec Inc Common Stock
STRF - MicroStrategy Incorporated - 10.00% Series A Perpetual Strife Preferred Stock
STRZ - Starz Entertainment Corp. - Common Shares
STT - State Street Corporation Common Stock
STXS - Stereotaxis, Inc. Common Stock
SUPL - ProShares Trust ProShares Supply Chain Logistics ETF
SUPN - Supernus Pharmaceuticals, Inc. - Common Stock
SVM - Silvercorp Metals Inc. Common Shares
SVOL - Simplify Volatility Premium ETF
SVRA - Savara, Inc. - Common Stock
SVT - Servotronics, Inc. Common Stock
SYNX - Silynxcom Ltd. Ordinary Shares
SYTA - Siyata Mobile, Inc. - Common Shares
SZZLU - Sizzle Acquisition Corp. II - Unit
TAC - TransAlta Corporation Ordinary Shares
TACO - Berto Acquisition Corp. - Ordinary Shares
TACOW - Berto Acquisition Corp. - Warrant
TAFL - AB Active ETFs, Inc. AB Tax-Aware Long Municipal ETF
TAL - TAL Education Group American Depositary Shares
TALO - Talos Energy, Inc. Common Stock
TAXX - BondBloxx ETF Trust BondBloxx IR+M Tax-Aware Short Duration ETF
TBLA - Taboola.com Ltd. - Ordinary Shares
TBLAW - Taboola.com Ltd. - Warrant
TBN - Tamboran Resources Corporation Common stock
TCOM - Trip.com Group Limited - American Depositary Shares
TDF - Templeton Dragon Fund, Inc. Common Stock
TEAD - Teads Holding Co. - Common Stock
TEC - Harbor ETF Trust Harbor Transformative Technologies ETF
TECS - Direxion Technology Bear 3X Shares
TECX - Tectonic Therapeutic, Inc. - Common Stock
TEKY - Lazard Next Gen Technologies ETF
TELO - Telomir Pharmaceuticals, Inc. - Common Stock
TENX - Tenax Therapeutics, Inc. - Common Stock
TER - Teradyne, Inc. - Common Stock
TERN - Terns Pharmaceuticals, Inc. - Common Stock
TEVA - Teva Pharmaceutical Industries Limited American Depositary Shares
TEX - Terex Corporation Common Stock
TEXN - iShares Texas Equity ETF
TFPM - Triple Flag Precious Metals Corp. Common Shares
TFSL - TFS Financial Corporation - Common Stock
TGI - Triumph Group, Inc. Common Stock
TGNA - TEGNA Inc
THCH - TH International Limited - Ordinary shares
THD - iShares Inc iShares MSCI Thailand ETF
THFF - First Financial Corporation  - Common Stock
THO - Thor Industries, Inc. Common Stock
THRO - iShares U.S. Thematic Rotation Active ETF
THTX - Theratechnologies Inc. - Common Shares
TISI - Team, Inc. Common Stock
TKR - Timken Company (The) Common Stock
TLCI - Touchstone ETF Trust Touchstone International Equity ETF
TLSIW - TriSalus Life Sciences, Inc. - Warrant
TLT - iShares 20+ Year Treasury Bond ETF
TMAR - First Trust Exchange-Traded Fund VIII FT Vest Emerging Markets Buffer ETF - March
TMCWW - TMC the metals company Inc. - Warrant
TMFC - Motley Fool 100 Index ETF ETF
TMFS - Motley Fool Small-Cap Growth ETF
TNGX - Tango Therapeutics, Inc. - Common Stock
TNMG - TNL Mediagene - Ordinary Shares
TNYA - Tenaya Therapeutics, Inc. - Common Stock
TOKE - Cambria Cannabis ETF
TOUR - Tuniu Corporation - American Depositary Shares
TOUS - T. Rowe Price Exchange-Traded Funds, Inc. T. Rowe Price International Equity ETF
TRC - Tejon Ranch Co Common Stock
TRN - Trinity Industries, Inc. Common Stock
TRNO - Terreno Realty Corporation Common Stock
TROO - TROOPS, Inc.  - Ordinary Shares
TRSG - Tungray Technologies Inc - Class A Ordinary Shares
TSLQ - Tradr 2X Short TSLA Daily ETF
TSM - Taiwan Semiconductor Manufacturing Company Ltd.
TSMX - Direxion Daily TSM Bull 2X Shares
TSPA - T. Rowe Price U.S. Equity Research ETF
TTE - TotalEnergies SE
TVAL - T. Rowe Price Exchange-Traded Funds, Inc. T. Rowe Price Value ETF
TVGN - Tevogen Bio Holdings Inc. - Common Stock
TWNP - Twin Hospitality Group Inc. - Class A Common Stock
TXN - Texas Instruments Incorporated - Common Stock
TXO - TXO Partners, L.P. Common Units Representing Limited Partner Interests
TYD - Direxion Daily 10-Yr Treasury Bull 3x Shrs
TYRA - Tyra Biosciences, Inc. - Common Stock
UAA - Under Armour, Inc. Class A Common Stock
UBND - VictoryShares Core Plus Intermediate Bond ETF
UBRL - GraniteShares 2x Long UBER Daily ETF
UFEB - Innovator U.S. Equity Ultra Buffer ETF - February
UGE - ProShares Ultra Consumer Staples
UHGWW - United Homes Group, Inc - Warrant
UHT - Universal Health Realty Income Trust Common Stock
UJB - ProShares Ultra High Yield ETF
UK - Ucommune International Ltd  - Ordinary Shares
ULST - SPDR SSgA Ultra Short Term Bond ETF
UMAR - Innovator U.S. Equity Ultra Buffer ETF - March
UMH - UMH Properties, Inc. Common Stock
UNF - Unifirst Corporation Common Stock
UNFI - United Natural Foods, Inc. Common Stock
UNL - United States 12 Month Natural Gas Fund
UOCT - Innovator U.S. Equity Ultra Buffer ETF - October
UPC - Universe Pharmaceuticals Inc - Ordinary Shares
URI - United Rentals, Inc. Common Stock
URNM - Sprott Uranium Miners ETF
URTY - ProShares UltraPro Russell2000
USD - ProShares Ultra Semiconductors
USHY - iShares Broad USD High Yield Corporate Bond ETF
USML - ETRACS 2x Leveraged MSCI US Minimum Volatility Factor TR ETN
UTHY - US Treasury 30 Year Bond ETF
UUUU - Energy Fuels Inc Ordinary Shares (Canada)
UX - Roundhill ETF Trust Roundhill Uranium ETF
UZE - United States Cellular Corporation 5.500% Senior Notes due 2070
VABS - Virtus Newfleet ABS/MBS ETF
VCIC - Vine Hill Capital Investment Corp. - Class A Ordinary Shares
VCICW - Vine Hill Capital Investment Corp. - Warrant
VDE - Vanguard Energy ETF
VEEE - Twin Vee PowerCats Co. - Common Stock
VEMY - Virtus ETF Trust II Virtus Stone Harbor Emerging Markets High Yield Bond ETF
VERV - Verve Therapeutics, Inc. - Common Stock
VFMF - Vanguard U.S. Multifactor ETF
VFQY - Vanguard U.S. Quality Factor ETF
VGI - Virtus Global Multi-Sector Income Fund Common Shares of Beneficial Interest
VGIT - Vanguard Intermediate-Term Treasury ETF
VGK - Vanguard FTSEEuropean ETF
VHI - Valhi, Inc. Common Stock
VICE - AdvisorShares Trust AdvisorShares Vice ETF
VIDI - Vident International Equity Strategy ETF
VIOG - Vanguard S&P Small-Cap 600 Growth ETF
VIOT - Viomi Technology Co., Ltd - American Depositary Shares
VIR - Vir Biotechnology, Inc. - Common Stock
VIRT - Virtu Financial, Inc. Class A Common Stock
VITL - Vital Farms, Inc. - Common Stock
VKQ - Invesco Municipal Trust Common Stock
VLN - Valens Semiconductor Ltd. Ordinary Shares
VLY - Valley National Bancorp - Common Stock
VNT - Vontier Corporation Common Stock 
VOE - Vanguard Mid-Cap Value ETF
VOO - Vanguard S&P 500 ETF
VOYA - Voya Financial, Inc. Common Stock
VPU - Vanguard Utilities ETF
VRE - Veris Residential, Inc. Common Stock
VRSK - Verisk Analytics, Inc. - Common Stock
VSA - TCTM Kids IT Education Inc. - American Depositary Shares
VSEE - VSee Health, Inc. - Common Stock
VSLU - Applied Finance Valuation Large Cap ETF
VSSYW - Versus Systems Inc. - Class A Warrants
VTEI - Vanguard Tax-Managed Funds Vanguard Intermediate-Term Tax-Exempt Bond ETF
VTES - Vanguard Wellington Fund Vanguard Short-Term Tax Exempt Bond ETF
VTGN - Vistagen Therapeutics, Inc. - Common Stock
VTYX - Ventyx Biosciences, Inc. - Common Stock
VV - Vanguard Large-Cap ETF
VVX - V2X, Inc. Common Stock
VWO - Vanguard FTSE Emerging Markets ETF
VXUS - Vanguard Total International Stock ETF
WABC - Westamerica Bancorporation - Common Stock
WAFDP - WaFd, Inc. - Depositary Shares
WDI - Western Asset Diversified Income Fund Common Shares of Beneficial Interest
WEA - Western Asset Bond Fund Share of Beneficial Interest
WEBL - Direxion Daily Dow Jones Internet Bull 3X Shares
WEBS - Direxion Daily Dow Jones Internet Bear 3X Shares
WEEK - Roundhill ETF Trust Roundhill Weekly T-Bill ETF
WEST - Westrock Coffee Company - Common Stock
WETO - Webus International Limited - Ordinary Shares
WH - Wyndham Hotels & Resorts, Inc. Common Stock 
WHF - WhiteHorse Finance, Inc. - Closed End Fund
WHLRP - Wheeler Real Estate Investment Trust, Inc. - Series B Preferred Stock
WIA - Western Asset Inflation-Linked Income Fund
WINT - Windtree Therapeutics, Inc. - Common Stock
WKEY - WISeKey International Holding Ltd - American Depositary Shares
WLFC - Willis Lease Finance Corporation - Common Stock
WLY - John Wiley & Sons, Inc. Common Stock
WLYB - John Wiley & Sons, Inc. Common Stock
WMG - Warner Music Group Corp. - Class A Common Stock
WMS - Advanced Drainage Systems, Inc. Common Stock
WOMN - Tidal Trust III Impact Shares Women's Empowerment ETF
WPC - W. P. Carey Inc. REIT
WPM - Wheaton Precious Metals Corp Common Shares (Canada)
WRLD - World Acceptance Corporation - Common Stock
WRND - NYLI Global Equity R&D Leaders ETF
WS - Worthington Steel, Inc. Common Shares
WSML - iShares MSCI World Small-Cap ETF
WST - West Pharmaceutical Services, Inc. Common Stock
WTIU - Bank Of Montreal MicroSectors Energy 3X Leveraged ETNs
WTMF - WisdomTree Managed Futures Strategy Fund
WTMU - WisdomTree Core Laddered Municipal Fund
WVVIP - Willamette Valley Vineyards, Inc. - Series A Redeemable Preferred Stock
WWR - Westwater Resources, Inc. Common Stock
WXET - Listed Funds Trust Teucrium 2x Daily Wheat ETF
WXM - WF International Limited - Ordinary Shares
WYNN - Wynn Resorts, Limited - Common Stock
XB - BondBloxx ETF Trust BondBloxx B-Rated USD High Yield Corporate Bond ETF
XBIT - XBiotech Inc. - Common Stock
XBJL - Innovator U.S. Equity Accelerated 9 Buffer ETF - July
XC - WisdomTree Trust WisdomTree Emerging Markets Ex-China Fund
XCNY - SPDR S&P Emerging Markets ex-China ETF
XDJL - Innovator U.S. Equity Accelerated ETF - July
XEMD - BondBloxx ETF Trust BondBloxx JP Morgan USD Emerging Markets 1-10 Year Bond ETF
XGN - Exagen Inc. - Common Stock
XHB - SPDR Series Trust SPDR Homebuilders ETF
XHYD - BondBloxx ETF Trust BondBloxx USD High Yield Bond Consumer Non-Cyclicals Sector ETF
XHYT - BondBloxx ETF Trust BondBloxx USD High Yield Bond Telecom, Media & Technology Sector ETF
XIDV - Franklin Templeton ETF Trust Franklin International Dividend Multiplier Index ETF
XLI - SPDR Select Sector Fund - Industrial
XMAR - FT Vest U.S. Equity Enhance & Moderate Buffer ETF - March
XMHQ - Invesco S&P MidCap Quality ETF
XNAV - FundX Investment Trust FundX Aggressive ETF
XNCR - Xencor, Inc. - Common Stock
XOMA - XOMA Royalty Corporation - Common Stock
XOMX - Direxion Daily XOM Bull 2X Shares
XPER - Xperi Inc. Common Stock 
XPEV - XPeng Inc. American depositary shares, each representing two Class A ordinary shares
XPH - SPDR S&P Pharmaceuticals ETF
XRMI - Global X Funds Global X S&P 500 Risk Managed Income ETF
XRPI - Volatility Shares Trust XRP ETF
XRPT - Volatility Shares Trust XRP 2X ETF
XTEN - BondBloxx ETF Trust BondBloxx Bloomberg Ten Year Target Duration US Treasury ETF
XTIA - XTI Aerospace, Inc. Common Stock  - Common Stock
XTLB - XTL Biopharmaceuticals Ltd. - American Depositary Shares
XTWY - BondBloxx ETF Trust BondBloxx Bloomberg Twenty Year Target Duration US Treasury ETF
XVV - iShares ESG Select Screened S&P 500 ETF
XXCH - Direxion Shares ETF Trust Direxion Daily MSCI Emerging Markets ex China Bull 2X Shares
XYZG - Leverage Shares 2X Long XYZ Daily ETF
YALA - Yalla Group Limited American Depositary Shares, each representing one Class A Ordinary Share
YCS - ProShares UltraShort Yen New
YELP - Yelp Inc. Common Stock
YFFI - Spinnaker ETF Series Indexperts Yield Focused Fixed Income ETF
YLDE - Franklin ClearBridge Enhanced Income ETF
YOLO - AdvisorShares Pure Cannabis ETF
YORW - The York Water Company - Common Stock
YSPY - GraniteShares YieldBOOST SPY ETF
ZALT - Innovator ETFs Trust Innovator U.S. Equity 10 Buffer ETF - Quarterly
ZAP - Global X U.S. Electrification ETF
ZAUG - Innovator ETFs Trust Innovator Equity Defined Protection ETF - 1 Yr August
ZD - Ziff Davis, Inc. - Common Stock
ZIM - ZIM Integrated Shipping Services Ltd. Ordinary Shares
ZJK - ZJK Industrial Co., Ltd. - Ordinary Shares
ZNOV - Innovator ETFs Trust Innovator Equity Defined Protection ETF - 1 Yr November
ZOCT - Innovator Equity Defined Protection ETF - 1 Yr October
ZS - Zscaler, Inc. - Common Stock
ZSC - USCF ETF Trust USCF Sustainable Commodity Strategy Fund
ZTAX - X-Square Municipal Income ETF
ZTR - Virtus Total Return Fund Inc.
ZYXI - Zynex, Inc. - Common Stock
